Juan	M
David	M
Gabriel	M
Erick	M
Erik	M
Omar	M
Sebastian	M
Ricardo	M
Carlos	M
Andres	M
Adrian	M
Santiago	M
Jhoan	M
Jhon	M
Tito	M
Teofilo	M
Hector	M
Tomas	M
Thomas	M
Cristian	M
Christian	M
Brayan	M
Brayam	M
Barayan	M
Barayam	M
Franco	M
Frank	M
Oscar	M
Jairo	M
Jeferson	M
Yeferson	M
Yoiner	M
Jesus	M
Fernando	M
Luis	M
Roosvelt	M
Adolfo	M
Rodolfo	M
Elkin	M
Habib	M
Freddy	M
Fredy	M
Gustavo	M
Diego	M
Esau	M
Ismael	M
Erwin	M
Eduar	M
Eduard	M
Edward	M
Edwar	M
Eduardo	M
Camilo	M
Samuel	M
Kevin	M
Zharick	M
Julian	M
Octavio	M
Miguel	M
Marcos	M
Mateo	M
Alfonso	M
Alvaro	M
Uriel	M
Moises	M
Abraham	M
Abram	M
Sergio	M
Sergey	M
Sergei	M
Kenji	M
Yuen	M
Lee	M
Felipe	M
Pedro	M
Bartolomeo	M
Cesar	M
Alexis	M
Alejandro	M
Claudio	M
Julio	M
Roberto	M
Robert	M
Steven	M
Estiven	M
Stiven	M
Mario	M
Giovanni	M
Giovani	M
Galileo	M
Jose	M
Rafael	M
Pablo	M
Timoteo	M
Guillermo	M
William	M
Wilmer	M
Anderson	M
Daniel	M
Van-Shtralen	M
Antonio	M
Josue	M
Josias	M
Felix	M
Martin	M
Brandon	M
Romeo	M
Gorge	M
Jorge	M
Elvis	M
Arturo	M
Javier	M
Xavier	M
Dwayne	M
Dwaine	M
Jordan	M
Yordan	M
Joaquin	M
Nicolas	M
Nicodemo	M
Manuel	M
Emmanuel	M
Emanuel	M
Caleb	M



Luisa	F
Tatiana	F
Gabriela	F
Linda	F
Camila	F
Kamila	F
Carla	F
Carlota	F
Ingrid	F
Astrid	F
Silvana	F
Silvia	F
Sofia	F
Sara	F
Sarah	F
Olivia	F
Dhanna	F
Dana	F
Danna	F
Dayanna	F
Dayannais	F
Dayana	F
Dayanais	F
Diana	F
Dina	F
Vivianna	F
Viviana	F
Bibiana	F
Bibianna	F
Biviana	F
Bivianna	F
Vibiana	F
Vibianna	F
Sahaira	F
Juliana	F
Julianna	F
Vannesa	F
Vanessa	F
Vanesa	F
Vannessa	F
Nathalia	F
Natalia	F
Sandra	F
Tania	F
Dalia	F
Marcela	F
Eunice	F
Catalina	F
Katerine	F
Dora	F
Rut	F
Ester	F
Monica	F
Alejandra	F
Andrea	F
Adrianna	F
Adriana	F
Ana	F
Anna	F
Isabel	F
Isabella	F
Isabela	F
Sixta	F
Maria	F
Fernanda	F
Gina	F
Galilea	F
Anastasia	F
Anabel	F
Eva	F
Celeste	F
Cielo	F
Rafaela	F
Carmen	F
Elizabeth	F
Daniela	F
Patricia	F
Zulay
Sulay
Sibisay	F
Saudi	F
Erika	F
Erica	F
Jenifer	F
Jennifer	F
Yenifer	F
Yennifer	F
Juana	F
Paola	F
Paula	F
Karol	F
Carolina	F
Carol	F
Heidy	F
Leonor	F
Laura	F
Tahis	F
Samanta	F
Samantha	F
Mayra	F
Julieth	F
Juliet	F
Sulaima	F
Xiomara	F
Jimena	F
Ximena	F
Noemi	F
Naomi	F
Clara	F
Estella	F
Estela	F
Stella	F
Stela	F
Mariluz	F
Maryluz	F
Luz	F
Jessica	F
Jesica	F
Jessika	F
Jesika	F
Yessica	F
Yesica	F
Yessika	F
Yesika	F
Yolanda	F
Norma	F
Nicole	F
Nicol	F
Eva	F
Manuela	F
Emanuela	F
Emmanuela	F
Beatrice	F
